##############################
#                            #
# # # #  ### ##  ## ##  #### #
#         @                  #
#    #       #   #  #   #  # #
# ### #     #  #  #  #  #    #
#           #   #  #  #      #
# ## ##    #  ###  #  #      #
#       #   #  #  #  #       #
#  ### #   #  #  #  #        #
#                        #   #
#         #  #  #  #         #
# ###    ##  #  #  #   ##### #
#       #   #  #  #  #       #
#   #                        #
# ###   #   #  #  #  #     ###
#           #  #  #          #
#    #                 #     #
#           #  #  #          #
##############################